District,Total_Schools,Primary_Schools,Secondary_Schools,Enrollment_Rate,Literacy_Rate
Central Delhi,245,89,156,94.2,89.5
North Delhi,312,134,178,92.8,87.3
South Delhi,298,112,186,95.1,91.2
East Delhi,267,98,169,91.7,85.9
West Delhi,289,123,166,93.4,88.7
North West Delhi,334,145,189,92.1,86.4
South West Delhi,301,118,183,94.8,90.1
New Delhi,156,67,89,96.3,93.8
Shahdara,278,105,173,90.5,84.2
Dwarka,245,98,147,93.7,89.6